い	i
ち	chi
に	ni
ん	n
さ	sa
よ	yo
ろ	ro
く	ku
な	na
お	o
は	ha
う	u
し	shi
あ	a
か	ka
む	mu
き	ki
る	ru
や	ya
け	ke
の	no
す	su
て	te
り	ri
ま	ma
ほ	ho
た	ta
こ	ko
ら	ra
わ	wa
ぬ	nu
ね	ne
と	to
せ	se
み	mi
め	me
ふ	fu
ゆ	yu
つ	tsu
も	mo
ひ	hi
れ	re
え	e
へ	he
そ	so
が	ga
ぎ	gi
ぐ	gu
げ	ge
ご	go
ざ	za
じ	ji
ず	zu
ぜ	ze
ぞ	zo
だ	da
ぢ	ji
づ	zu
で	de
ど	do
ば	ba
び	bi
ぶ	bu
べ	be
ぼ	bo
ぱ	pa
ぴ	pi
ぷ	pu
ぺ	pe
ぽ	po